AAA	K	Lys
AAC	N	Asn
AAG	K	Lys
AAU	N	Asn
ACA	T	Thr
ACC	T	Thr
ACG	T	Thr
ACU	T	Thr
AGA	R	Arg
AGC	S	Ser
AGG	R	Arg
AGU	S	Ser
AUA	I	Ile
AUC	I	Ile
AUG	M	Met
AUU	I	Ile
CAA	Q	Gln
CAC	H	His
CAG	Q	Gln
CAU	H	His
CCA	P	Pro
CCC	P	Pro
CCG	P	Pro
CCU	P	Pro
CGA	R	Arg
CGC	R	Arg
CGG	R	Arg
CGU	R	Arg
CUA	L	Leu
CUC	L	Leu
CUG	L	Leu
CUU	L	Leu
GAA	E	Glu
GAC	D	Asp
GAG	E	Glu
GAU	D	Asp
GCA	A	Ala
GCC	A	Ala
GCG	A	Ala
GCU	A	Ala
GGA	G	Gly
GGC	G	Gly
GGG	G	Gly
GGU	G	Gly
GUA	V	Val
GUC	V	Val
GUG	V	Val
GUU	V	Val
UAA	-STOP-	-STOP-
UAC	Y	Tyr
UAG	-STOP-	-STOP-
UAU	Y	Tyr
UCA	S	Ser
UCC	S	Ser
UCG	S	Ser
UCU	S	Ser
UGA	-STOP-	-STOP-
UGC	C	Cys
UGG	W	Trp
UGU	C	Cys
UUA	L	Leu
UUC	F	Phe
UUG	L	Leu
UUU	F	Phe
